21
11
#####################
#..O..   O  * *     #
# * O.   O..      O.#
#     O   ..  OO   .#
# .G.   ...R. *O   .#
#################  .#
# ....             .#
# .O   ..O    ..G...#
#   ..R O*  ....**  #
#D **.. O* ..R..**  #
#####################