24
15
########################
# ...    O    ** ..X.. #
#   ...    OO    ..    #
#               OO     #
#          **       ..G#
###################    #
#                      #
#        * O   . O..   #
#         **       OO  #
# ..G...         *     #
##########    ##########
#        ..OO...  *    #
#                 ...  #
#      **  .X.     X.D #
########################