21
11
#####################
#  O     O  * *     #
# *                 #
#*  ####     ####   #
#       ...   OO    #
# .X.   .X.   *O    #
# ...  ####         #
#     OOO     ..X...#
#   ..X O     ..**###
#  **.. O ...X..#**D#
#####################