13
11
#############
#.          #
#           #
# *   *   * #
# ** * * ** #
# * *   * * #
# *   D   * #
# ********* #
#           #
#           #
#############