15
10
#         H   #
#     ..      #
#     X.      #
#             #
#             #
#        O    #
#   *         #
#         D   #
#             #
#             #