21
11
#####################
# .O     O  * *     #
# *                 #
#*  ####     ####   #
#       ...   OO    #
# .G.   .X.   *O    #
# ...  ####         #
#     OOO     ..G...#
#   ..X O     ..**###
#  **.. O ...X..#**D#
#####################